8,8,8,8,8,8,8,8,8,8,8,8,8,8,8,8,8,8,8,8,8,8,8,8
8,0,0,0,9,0,0,0,9,0,0,0,0,0,0,0,0,0,0,0,0,0,0,8
8,0,0,0,9,0,0,0,12,0,0,0,0,0,0,0,0,0,0,0,0,0,0,8
8,0,0,0,9,0,0,0,9,0,0,9,0,0,0,0,0,0,0,9,9,12,11,8
8,0,0,0,9,0,0,0,9,0,0,9,0,0,0,0,0,0,0,9,0,0,0,8
8,0,0,0,9,0,0,0,9,0,0,9,0,0,0,0,0,0,0,9,0,0,0,8
8,0,0,0,9,0,0,0,9,0,0,9,0,0,0,0,0,0,0,9,0,0,0,8
8,0,0,0,9,9,9,9,9,0,0,9,9,9,9,9,9,9,9,9,9,9,9,8
8,0,0,0,0,0,0,0,0,0,0,0,0,0,0,0,0,0,0,0,0,0,0,8
8,0,0,0,0,0,0,0,0,0,0,0,0,0,0,0,0,0,0,0,0,0,0,8
8,9,9,9,9,9,9,9,9,9,9,9,9,9,9,9,9,9,9,9,9,0,0,8
8,0,0,0,0,0,0,0,0,0,0,0,0,0,0,0,0,0,0,0,13,0,0,8
8,0,0,0,0,0,0,0,0,0,13,0,0,0,0,13,0,0,0,0,13,0,0,8
8,0,0,0,0,0,0,0,0,0,13,0,0,0,0,13,0,0,0,0,13,0,0,8
8,0,0,0,0,0,0,0,0,0,13,0,0,0,0,13,0,0,0,0,13,0,0,8
8,13,13,13,13,13,13,13,13,13,13,0,0,0,0,13,13,13,13,13,13,0,0,8
8,0,0,0,0,0,0,0,0,0,0,0,0,0,0,0,0,0,0,0,0,0,0,8
8,0,0,0,0,0,0,0,0,0,0,0,0,0,0,0,0,0,0,0,0,0,0,8
8,0,0,0,0,0,0,0,0,0,0,0,0,0,0,0,0,0,0,0,0,0,0,8
8,6,6,6,6,6,6,6,6,6,6,0,0,2,1,2,2,1,2,2,1,1,2,8
8,0,0,0,0,0,0,0,0,0,3,0,0,2,0,0,0,0,0,0,0,0,0,8
8,0,0,0,0,0,0,0,0,0,0,0,0,2,0,0,0,0,0,0,0,0,0,8
8,0,0,0,0,0,0,0,0,0,3,0,0,2,0,0,0,0,0,0,0,0,0,8
8,8,8,8,8,8,8,8,8,8,8,8,8,8,8,8,8,8,8,8,8,8,8,8
